d28x16
0000000000008000000000000006
0000700000000000000000700006
0031113000011311000031113006
0310701331133333113310701306
1311111311333333313111111316
0000080003333733330000000006
1111111113333333331111111116
0117110001333333310011711006
0011100000133333100001110006
0001000000013331000000100006
0000000000001310000000000006
0000000000001310000000000006
0000000000001310000000000006
0000000000001310000000000006
0000800000000300000900000006
1111111111111111111111111116
