d28x16
0000000000000000000000000000
0000000000880660880000000000
0000000007776116777000000000
0007777762222222222677777000
0061111110000000000111111600
0066600000000000000000066600
0000600000000000000000060000
0000600000000000000000060000
0000600000000000000000060000
0000600000000000000000060000
0000600000000000000000060000
0000600000000000000000060000
0000600000000000000000060000
0000600000000000000000060000
0000600000000009000000060000
2111111211111221111121111112
