d28x16
0000000000008000000000080000
5353535353535353535353535356
5353535353535353535353535356
7313031373130313731303137316
5313531353135313531353135316
5313531353135313531353135316
5313531353135313531353135316
0313731303137313031373130316
5313531353135313531353135316
5313531353135313531353135316
7303030303030303030303030316
3111111111111111111111111116
3000000000708070007080000006
3222222222222222222222222226
3700000009000000000000000076
1111111111111111111111111111
