d28x16
1111221111111111111111111116
1070020000070080000900000016
1313021513111111511111111016
1311301513311744444444700016
1301130511331170007007113016
1300113011133117000071103136
1330011301133311700711003336
1333701330131331100110013316
1333300313031133151100133316
1733338311331113351003337316
1337003301130111350713333116
1113111170113011300133383316
1333333330013303383337003316
1303307003003133313311111316
1703131111300000333700000306
1111133337311111331111111111
