d28x16
0000000000000000000000000600
0000000000000000000090000060
0005111133111111333330000006
0000000003000100300000000060
0000700000303100300000000600
0000170000033100300000006000
0001117000003100300000060000
0011111700003100300000600000
1111111100003100300000060000
0711111000003100300000006000
0001110000003100300000000600
0000100000003100300000000060
0000000800003100300080000006
0311111111111111511111111106
0111111111111111000000000316
1111111111111111000777777311
