d28x16
0000000000003113000000000000
0000000000873113780000000000
0000000000311111130000000000
0000000007311111137000000000
0000000031111111111300000000
0000008731111111111378000000
0000003111111111111113000000
0000073000777777770003700000
0000311111111111111111130000
0007311111111111111111137000
0031111111111111111111111300
0031111111111111111111111300
0030000000000000000000000300
0030000000000000000000000300
0030000000000900000000000300
1111111111111111111111111111
