d28x16
0400000000000000000000000040
3011111111111111111111111103
3010000100700710000000100103
3010700111151110000000100103
3015111100000107807000107103
3010001000000111111111111103
3010701000000100000010000103
3011111007080100000010000103
3010001111111110000010070103
3010000001000017008011511103
3010700701000011111110000103
3011151111000010001000000103
3010701700087017001070000103
3011151111111111511111151103
3000000000009000000800000003
1111111111111111111111111111
