d28x16
1000040000090000400001070000
1111301111111111031111011113
1111301001111101031111000703
1711301011111001031171031111
1111301001111101031111037000
1171301011111001031711011113
1111301001111101031111000073
1711301011111001031111031111
1111301001111101030111030700
1171301011111001031111011113
1111301000111101031711007003
1711301711111771031111031111
1111301111111111031170030070
1171301111111111031111011113
1111300800000800031111008003
1111111111111111111111111111
