d28x16
0000000000000000600000000000
0840000000004900600000400000
0303000000030300600003030003
3003300000300030600030003003
0173030003017103600301710343
0113004443811103444381310003
2113115112112112115112315113
1003005001007111007101305003
1443445441031444434444341443
1003005001031001035301807003
1523121521131121125321121513
0511110001131100015311000513
0003444044131440445314404413
0013100700131007001300070013
0713100200131002001310020013
1503051211030112110301121503
