d28x16
4444444444400000000000000000
0000000000030000010004040000
0070070070834444011110301111
1111111111100000311110305111
7700000007704444311110305111
1170000071130000010110305771
1117000711134444010110305111
1111707111100000310110305771
1111171111100800310110305111
1111111111131111117710305771
0000000000030000011110305111
1610000900030000000008305771
1611111111111311111111115111
1600001117111311111700000000
1600001111711311707113000007
1670071111100300111111111111
