d28x16
0000008000600000006000800000
0000000000060000060000000000
0000000000006000600000000000
0000000000711131117000000000
0000000000171737171000000000
0070000001730313037100007070
0011313111111303111111313110
0710313000000333000000313710
0103313333333333333333313301
0138701333333313333333107831
0011130130700303007031031110
0007113111111131111111311700
0001103000007030700000301100
0001031133333313333331130100
0700311133313333313331113970
1111111111111111111111111111
