d28x16
1111111161111111111111111111
9020022260002301000344444440
1300030232202371322300000000
7322130232200300300000000070
1130030230011132344444000000
7231127231144432300000001111
0030000232072032110007000000
0830070232111132030000000800
2211310232000034432222222222
3002310032111111030002444442
3100311132071700111302030002
3203220232001000000300030002
3203207230001111111111132002
3011102232111000000000030002
3000080032702307000070030002
1111111112117322111122230072
