d28x16
6000000000000000000000000000
6000000000000000000000000000
1111111111111113110700000090
0000800000800003115122222223
7003333333333303000000000003
1703003333333303070703111113
0173003000000003016101111113
0013003707070700301000000003
0001703151515103000008707073
0000103000000000300001311113
0000003030303003000000300000
0000003000000000300000308000
0000000303030003000000111113
0000000030303000300000000003
0000800007610003000800000003
1111111111111111111111111111
