d28x16
4444444440000300000044444000
0000000003000030000300000000
0004444443070003000300000000
0030708001110003000030000000
0030111100000030444003077440
0030000000000300070003022000
0034444000703000020030000007
0000000301103000000300000001
0000000300000300000222111211
0000000300000030440000000000
0007870300000003000000000202
0011110344440003000222222202
7000000007700030700000070782
2000000002200300100111111111
0000000000090300000000000000
1111122211111111122211111111
