d28x16
0000000000000000000000006000
0007000000000000000000006000
3211000000000000000000006223
3271107000000000000000076223
3001711100000000008011111113
3001010011170000011107000003
3440017010010070117022220003
3001111110001115100000011123
3709000000000000012223107003
3222244444444000000003111703
3000200008777700000003001111
3070270022222222220003072007
3111110000000000000003112211
3444434444440000000003000000
0000030000000000000003800000
0007030001111111111111111111
