d28x16
6000000000000000000000000000
6000700070007808700070007000
1111111111111161111111111111
0000000000000030000000000000
0000000000000131000000000000
0000000000000737000000000000
0008000000001131100000008000
0003000000007030700000003000
0013100000011131110000013100
0073700000070030070000073700
0113110000111131111000113110
0703070000700030007000703070
1113111001111131111101113111
7003007007000030000707003007
0003000000000030900000003000
1111111111111111111111111111
