d28x16
6000000000000000000000000006
6000000000000000000000000006
6444443000003444444310000013
0000003444443000000310700013
0700003000003080700311111513
1110701330001111111111111513
1111111030700000000007000003
1111170031100071700011000003
1111117031100711170011000003
1111111731107111117011080703
1111111131151111111111132213
1000000830000000000000030113
1007001130000000900000030113
1111111134444311113744430113
1007000030070311713100137113
1111111111111111113111131113
