d28x16
0030008000040008430000340007
0430004340004004034000304003
4030040304000040030400300403
7030400300400400030047300043
0034004300044000037004300003
3400040340044004034444440400
3040004300470400030040003040
3404000374430040030000043004
3040400344030004030000403004
3407048340030400434004003004
3043004000030004000400003004
3403000400030040400040003004
3043040040037400040004003074
3403000404034040074000403040
3043004000430000040404043400
0003000007000007900000003000
