d28x16
0000002444444400444033113006
7000872444444711000331133006
1113112000007110003311337006
0003002000071100033113370226
7003072000711000331133702206
1113112007110003311337022006
0093002071100033113370220776
1113072711000331133702203110
1113112110003311337022003770
1713002070033803370220311110
1113072111111111113200370870
7113112444444444443203111110
1113072707003000000203700070
1222222111003011110203111110
0000000000083117711203700070
1111111111112111111201111111
