d28x16
6000000000000000000000000000
6000000800000000007000000000
6022322220000000002222322222
6000300001700000010000310444
6444344444100000144444323007
1700300700010001000000313440
0180344401301010007000320003
0010000010300500000000317003
9001000100300000000070320443
2210101000310444444010313000
0000150000301070000100323080
7311100000300100001070311113
1324444444300010010011311113
0300000000000005500000300003
0300000000000000000000300003
2222221111111222211112222222
