d28x16
2222222222226002220000000212
1111111211226001120000000121
0007001212126002120000000100
3211151000026080120000007107
3111100044443112125111113203
3107104442123100005211113103
3111444002123144445211113213
3114440000003200000701123113
3144700011213100005112213113
3440244444443000444440113013
0002180070023511209070003113
1151211021123511221221200003
1151200000023500008070211111
1151244444443511001111200701
1100000700023000000000011111
1211112113003003111211111111
