d28x16
0000000000000330000000000000
0083000000000330000000003080
0113110000011331100000113110
1173711000111331110001173711
1003000001170330711001003000
1173704441100330000001173700
0113110001170338700000113110
0073711000111331100000073711
0003001000011331110440003001
1173711000070330711001173711
0153510000000330011000113510
0003000001170338711000003000
0000000000111331110000000000
0000000000011331100000000000
0000000090000330000000000000
1111111111111331111111111111
