d28x16
3000000000000000000000000003
3000003171130000031171300003
3870003111130000031111300073
1111303111134444431111303111
0000303117130000031711303000
0078303111130000031111303700
3111103111130000031111301113
3000003171134444437111300003
3070003111130000031711300703
1111303117130000031111303111
0000303711130000031171303000
0070303111134444431111303070
3111103171130000031117301113
3000003111130000031711300003
3009003117730080031111300803
1111111111111111111111111111
