d28x16
6000000000000000000000000006
6000000000000000000000000006
6000000000800000000000000006
3111511111111111111111111113
3111511111111111111111111113
3000700011444444441100000003
3000000071300008071100008003
3001110011301111111100111113
3001710011300000001100117113
3000900011300000001100111113
3001110011111111331100117113
3001110011111111331100111113
3001110011000000301100000003
3001110011000007301100007003
1111111111311111111131111111
1111111007311111107031111111
