d28x16
1161212121212210161201161111
1161111112122320262101060031
1260000001200300060700860031
1115113444444311511111111131
0907003731270302002120010031
1111131132120070200002044431
0021032032221221020044444131
7080030030014444444442071131
1521130037221701270020011031
2502030072122170214443100031
0010030720777027002003000030
3444437203121002700013111111
3030022443000000200703022222
3031217703443003011113002001
3037071178773443001123000871
1111111111113073711111111111
