d28x16
0000000000000000000000000000
1111113600000000000063111111
1113337600000000000067333111
3311133370000000000733315133
7333151333780000873331113337
0073331113337007333151333700
0000733315133333311133370000
0000007333111331113337000000
0000000073331331333700000000
0000007333111331113337000000
0000733311133333315133370000
0073331513337007333111333700
7333111333700000073331513337
3315133370000000000733311133
1113337600000000000067333111
1111113600000009000063111111
