d28x16
0444444444400900044444444440
3000044440011111100444400003
3000044401111111111044400003
3000044011111111111104400003
3000040111117777111110400003
3000040111111111111110400003
3000001111111111111111000003
3000001177771111777711000003
3000001111111111111111000003
3000001111117777111111000003
3000000111111111111110000003
3000040111111111111110400003
3000040017777117777100400003
3000044001111111111004400003
3877744470011111100744477783
1111111113777777773111111111
