d28x16
0000000600000000000000000000
0000000600000000000000000000
0000000600032222222222222222
1133111311130000080004444444
1713101310131111111111110070
1013171317133337333373331113
1533111310133222233222330003
3333333333333200733200331137
3300003011033204233207331031
3301113017133222233222331301
3301703001133444403333331300
3301103010130070003333311113
3300003911031111111007311173
3333333222231333332011311103
3000007002231303032011301131
1111130008001303732007310831
