d28x16
3000000000000000000000000000
3004400000044444444444444444
3000600000730000700003000803
1110111111134444444303032222
0700000000030700000303030000
2223111080034444444303022223
0003070111110000700303000003
0903011111714444444303032222
3103444444444444444303030700
3111111151111100080003022223
3700111100000170011113000003
3111111111111122011111131111
3211111111111100011111131117
3211111111111132011711131111
3207111111111132000000030000
3011111117000032111111111111
