d28x16
0000000300000000000000000000
0870000300000000000000000780
3118700300000000000000078113
3001100311116311111300011003
3000000000003370000300000003
3000000000007330000300000003
3000000000003370000000000003
3000000000007330000000000003
3000000000003370000000000003
3000000000007330000000000003
3000000000003370000000000003
3000000000007330000000000003
3000000000003370000000000003
3000000000007330000000000003
3000000090003370000000000003
3000031111111111111111300003
