d28x16
6000000000000000600211110000
6111111111111111600207310700
6444444444443001344211310222
7312100000703441300070310003
2300011000003001300211310073
2311007100093001307280313443
3307111111113001300213113003
3001110000023001300003003070
3000110000723001130003003111
3300011111123800111303003000
2311144444421130001113303113
1300008000000012300011310003
1311111113000000123000310003
1311711113111113111223311103
1311111713111113700703317003
1311111111111111111113111113
