d28x16
0006000000000000000000000000
0006000000700000000070000007
3513000031113000003111310013
3001111110003111113000300703
3708000000003000003000111103
3511110000000001113100000003
3021111000000011000000003103
3021111100000110000000313003
3021111111111100007000300011
3021111111111100011100300000
3020000111011100000000300087
3020070110701100000800300011
3023111111111113111111300011
3003000000000003000000300011
3003000000090000000000300011
1111111111111111111111111111
