d28x16
3301111183222022238111110332
3233070332333333323307033233
7323131323711311732313132371
1032333230103330103233323013
0133232331030003013323233100
3103333301301110310333330131
3130000031310701313000003139
3103333301301110310333330131
0133232331030003013323233100
5032333230103330103233323013
7323131323711311732313132371
3233070332333333323307033233
2301111103222322230111110322
2303070303223332230307030322
2303131383323332338313130322
3232333232333333323233323233
