d28x16
0007000000404008000400000048
3111031111717111113040000403
3007031111111111113047040703
3111031171111171113400404043
3007031111111111113070007003
3111031711111117113044004003
3007031111111111113040704743
3111031171111171113000400403
3007031111111111113004040003
3111031117111711113400404043
3007031111111111113007000403
3111031111717111113000440703
3007031111111111113040040403
3111031117111711113070404043
3080031111111111113000009000
3111131171111171113111111111
