d28x16
4444444444000000004444444444
3000000000111111110000000003
3000000011111111111100000003
3000800111111111111110080003
3022221111111111111111222203
3000000001111111111000000003
3023000000001111000000003203
2223000000000000000000003222
0003007007007007007007003000
0003000000000000000000003000
0003000000001111000000003000
0003000001115555111009003000
0003001115555555555111003000
0003000555555555555550003000
0003000055555555555500003000
0003000000555555550000003000
