d28x16
0000000000000000080808400000
0000000000000003111111031113
0000000000000003100001031113
0000000000031111110001031113
0000000000031000010001031113
0000000311111100017771031113
0000000310000100011111031113
0003111111000177710000031113
0083100001000111110311111113
1111110001777100008310000113
1000010001111103111111000113
1000017771000003100001000113
1000011111031111107771777113
1777710000031222222122212223
1111110311111000000009000003
0000000311111111111111111111
