d28x16
0000000000000000000000000000
0000000000666666660000000000
0000000000311111130000000000
0000000080310800130800000000
0000000000310070130000000000
0000031111111111111111300000
0000031000010000100001300000
0000031000010000100001300000
0000031000010000100001300000
0000031007018070100701300000
3111111111111151111111111113
3100001000010000100001000013
3100001000010000100001000013
3100701007010070100701007013
3131131311313113131131311313
3031130311393113831130311303
