d28x16
0000000000003330000000000000
0000000000033330000000000000
0000000000000330000000000000
0080000000003333000000000800
4444444444433333344444444444
4444444444433333344444444444
0444444444433333344444444440
0004444444433333344444444000
0000044444433333344444400000
0000000044433333344400000000
7070707070033333300707070707
0000000000033893300000000000
1111111111133113311111111111
1111111111133113311111111111
0707070700003003000070707070
1111111111111111111111111111
