d28x16
0000000000000000000000000006
4444444401300000000000070076
0007170031312121212125212121
0071017031300007000700444444
0710001731121212121213000003
0100000531222222222223007003
0000000034444444444311151113
0000000000000000000310000003
0070970000000000000310000003
3111111130807007000310700783
3087007031212121212122125213
3111111131111117011100000003
3007070031111111101100000003
3111111131111111110100000003
3000707031111111111007007003
1111111111111111111111111111
