d28x16
0000000000000000000002222223
4444444444444400800000000003
3000000000000322222220310361
3083230000000344444301301300
2222232320900000000300110615
3444430315111222011301136615
3000030310710007000301031445
3000000310071111022307317077
3000000310811111000301310001
3570000010111117022366313111
3010000010711111070300103110
3001000010111111032301113011
3000100013071701030300103107
3000010003111111032301011011
3000000010000000000300000000
1122211111111122221212221222
