d28x16
0000000000006000000000000000
1000000000176710000000001000
0144434444413144444344410000
0017030800073700080307100000
0001434344413144434341000000
0000100300503050030010000000
0344410301443441030144444430
0343001310000000131000003430
0003001310000000131000003000
0343001310907000131111003430
0300001311111111131111000030
0343001310111110131171003430
0073001310117110131111003700
0343801310111110131000083430
0344440304000004030444444430
0300001310111110131000000030
