d28x16
1600000000000000000000000001
1644444444444444444444444441
1600000005111311150000000001
1600007515000300051107000001
1600751577777377877151070001
1601151511111311111151510701
1111000000000300000000015151
1100000777700380777700000151
1000031111115311111113000001
1000030000000300000003000001
1000730077777307077773080001
1035111111111351111111113001
1030000000000300000000003001
1030000000000300000000003001
1030000000000300900000003001
1111111111111111111111111111
