d28x16
0000000000001110000000000006
0000700807002220000078007006
3111111111111113111111111111
3444444444402223000000000000
0000000000031113004444444440
0444444444432223700000000003
3070044449001111110000000731
1111100001302222220000873111
0040100001301111110007311111
1173100001302222220731111111
7113100001344444073111111111
1173100001302220322222222222
7113107701301110300000000000
1173111151302220311111111113
7113008000371117317000000003
1111111111112221112222222222
