d28x16
0000000000000600000000000000
0000000000000600000000000000
0000000003000600000000000030
0001111113000344444444444430
0001007013000300000000008030
0001000013000322222211221122
2122122122122314444415111001
0780700000700310300014401001
1111111511111310317717131701
0444444444444310311115131001
3800000000000310370004433311
3111111111111311111130700300
3000000000009300000031100333
3711111070111311070131744003
3110701111170371111131170113
1111111111111111111130011111
