d28x16
0000000000000000000000000000
0000000003110000113000000000
0000000031100000011300000000
0000000311000000001130000000
0000003117008000007113000000
0074431111111111111111344780
0313000117000000007110003130
0331300011070000701100031330
0733138001111001111000313370
0073313000111001110003133700
0007331300011791100031337000
0000733130001111000313370000
0000073313000330003133700000
0000007331300330031337000000
7008000731130330311370008007
1111111111111111111111111111
