d28x16
4444444444444444444444430000
0070000700000700000700030000
1111001111001115001151030000
0000070000700000070000030000
1001511001151005111001030000
0700000070007000000700030000
1111001111001115001151030000
0000700000700000700000030000
1001151001511005111001030000
0070000070000070000700030000
1111001111001115001151030000
8000090000000000080000030008
1111111111111111111111116111
1111111111111111111111116111
1111111111111111111111006001
1111111111111111111111086801
