d28x16
0000000000000060000000000000
0004444444400464440000000000
0030000000034000003031111300
0034444444834444440310340130
0030000000310044403100307053
0030000003501300031000300071
0030044031000130409444344441
3013360317311013001000000001
3101360311111113001111011111
1151160310017013430000400083
1151160311111110031111011113
1070160310710013031711011113
1111160311111113031111011713
1111160310017003031000010003
1000160311111113031151115113
1070061300000013130001007003
