d28x16
1111111111110000111111221116
1444444444444444444444011016
1031111111113006144444344446
9037277770003006170077300076
1131111121113006111311151316
1033333020073006170344444306
1700273007713006120302220376
1111111511113006170380077323
1007277020013006111111311113
1002222020013443170000300776
1077707727013783127000301113
1311151111311111111131111113
1344444444311104444434204443
1307007770300730707030237071
1131132131115131121511111311
0737738030000030000000077377
