d28x16
4444444444444344444444444444
0700000070000300070007087007
8700700008070307000707000000
0151151303151111303151000000
0151151133151111533151000000
0151151153151111513151000000
0151001153151001513151000000
0151001153151001513151000000
0151001153151001513151000000
0151001153151001513151000000
0151071153151071513151000000
0151511153151511513151115110
0151511103151511503151115110
0151511003151511003151115110
0000000003000900003000000000
1111111111111111111111111111
