d28x16
0000000440000000000440000440
0111111743111111113471111740
0111111173111111113711111170
0111111113111111113111111110
0111011113111000003111000110
0111001113111777003111777440
0111001113111111003111111740
0111001113111111003011111170
0111001113111111003001111110
0111071113111000003000001110
0111711113111777773117771110
0111111113111111113115111110
0111111103111111113015111100
0111111003111111113005111000
0080080003000900003000800800
1111111116111331116111111111
