d28x16
0000000000000000000000000000
0000044460000004440000400044
3000300412222220001111022300
3700370010002700000000000307
1134223023002212055551103151
0730873023002700000000003000
3114322023302213050000503000
3700370020330023001771003000
1134223020033023000113443070
8730073020003323000003001151
3114322020000323008003000000
3700378020000023222222223070
1134223020000023100707013151
0730073020000023131212113000
3114222028773103130707003000
3090000011111122112121212121
