d28x16
0000000000000600000000000000
0000000000000600000000000000
0000000000800600744400000000
0444444443222215110030000000
3000000003000000070030000000
3000000111111222111111100000
3000000170100010001000100000
3080770100100710771077107000
3111111100111111111111111110
3100101111100000100000000000
3107107001000370109000000700
3111111111112321111111511111
3000000000000300000000004440
3000000000000300000000030070
3000000007000300000000030111
1111111111111300007080030070
