d28x16
4444444444444444000000000000
0000070000000000380000000000
0000777000000003330000000000
0000777000000003330000000000
0007700000000033000000000000
0770777000003303330044444444
7707700770033033003300080000
0003300000000033000000333330
0803330000000033300000777770
3333033000033330330000333330
0000033000000000330000777770
0000033000000090330000333330
1111111111113111111111111111
0000000000003000000000000000
0000000000003000000000000000
1111111111111111111111111111
