d28x16
7800000111111111111111111111
1130000111111111111111111111
3111130000111111111111111111
3111111130800111111111111111
3111110111130000111111111111
3111110111111130000111111111
3111110111111111130800111111
3111107011111111111130000111
3111111107011111111111130000
3111110111107011111111111113
3111110111111107011111111113
3111110111111111307011111113
3111110111111111311101111113
3700070007000701311101111113
1111111111111100311100000093
1111111111111111111111111111
