d28x16
0444400000000890000000044440
3000011370000000000731100003
3000011370000000000731100003
3000001137000000007311000003
3707001137000000007311007073
3111130113700000073110311113
3700730113700000073110370073
3111113011370000731103111113
3780873011370000731103780873
3111111301137007311031111113
3700007301137007311037000073
3111111130113773110311111113
3700000730111111110370000073
3111111113011151103111111113
3700000073077157703700000073
1111111111111221161111111111
