d28x16
0000006000000000000000000006
0000006000000800000000000006
4440806444444111113000080006
3112111011111113711111111113
3117111027000313110007000703
3111111022222323000444444403
3000000004444303000300000003
1151113000000003000300100003
4440003111111011111113111111
7000311000004444103333333344
0000310022230000173333333307
3111100100022230143333333304
3000001003111130173333333300
3000310003111130143333333300
3900313003107130111111111113
1111111111111110000000000003
