d28x16
0000000000000000000008880000
0000000000000000007777776000
0000000000077777761111111000
0000777777622222220000000000
0006111111100000000000000000
0006600000000000000000000000
0000600000000000000000000000
7777600000000000000000000000
1111300000000000000000000000
1111111111300000000000000000
1111111111111113000000000000
1111111111111111111300000000
1111111111111111111111300000
1111111111111111111111113000
1111111111111111111111111300
1111111111111111111111111390
