d28x16
0000444444000000000000004000
0111000000344000800311110000
0170000003440111111311110000
0111000004400511115317710000
0000011150000511115311110000
0000011150114517715300005111
0000017750110511115300005111
0000011150000000000300005771
0000000000000000000300005111
0000000005115000000300000000
5111500005775000000351110000
5111500005115000000351110110
5070500000000000000357710110
5111500000000000000351110000
0000000000000080000309000000
1111111111111111111111111111
