d28x16
6000000000000000000000000006
6000000900000000000080000006
6000213124444444444213120006
6000273020700000070203020006
6021103011200000021103711206
6627003007207000720703017266
2611103000112002111113010162
2000003000002072700003010072
2000003111112312110073011012
2070803000800300000113000002
2311113000211311120003000132
0320703000100307010003008230
0321103011100300011103011230
0307203020000300007203027030
0300011100000300000011100030
1111111111111111111111111111
