d28x16
2222222222222222222222222261
3444444444444444444444436661
3003000001100800070000036701
3003011111111111111111111131
3003011100000000000070000031
3003000101111111111111111111
3003003100070010701070107001
3003003113111111111111111111
3003443003111110111110000001
3003003003000010710000080001
3003003003443011113441111111
3003003003003000003001111111
3003003003003443003001111111
3003003003003003013111077701
3003903003083003003111311111
1111111111111111113077311111
