d28x16
0000200000200000200000000062
0000200000200000200070000062
0000251111200000211110011162
1110000000001113800700000762
1111111111130003111111110132
0000000900030113100070000132
1311111111130713101111130132
1444444441130113101000030132
1001001071130003301011130132
1001001001331111311711130132
1001071001310000001011130032
1001111001310111101000031332
1311001133310171101111111302
1300022133110001001170000312
1300020003115111151111111312
1311100003000008000000000302
