d28x16
0000000000000000600000000000
0000000000000006600000000000
0000000000000066000000000000
0000000000000660000000000000
0000000000006600000000000000
0000000000006000000000000000
0000000000311300000000000000
0000000000311370000000000000
0000000311111113008000000000
0130080310707013013130000000
0011131111111111113111300000
0001107001111070003700113000
0000111130070111303113013000
0000017131113070303713713000
0080001111111111111111113090
2222222222222222222222222222
