d28x16
0080440400000000000008000000
1111003000400000000011300000
1111003011040008000411300000
1771003011401111111004300000
1111003000001111111030311100
0000003444001111111030017100
0000400000301111111030011100
0000011110301177711030000000
0004011110301111111030000000
1114017710340000040430000000
1710011110304000403001111000
1110000000300090003001111000
0000000000300111003001771000
0001100000300171003001111000
0001100000300151003000000000
0000000000300000003000000000
