d28x16
0000000000000000000000000060
0000080000000000000000000060
3111111111130080070000070060
3000000000031111130001113111
3070000007030000230000003000
3010011101030770230000803000
3010111001030220211111111122
3010011101030220000000000027
3010111001030244444440070023
3017011101030270000001111323
3011111001030220000000000303
3011111111030220000700000311
3000000000030220111111000300
3222222221222220000000000300
3000000000000090000000000300
1111111111111111111111111111
