d28x16
0002222222220000000000060000
0020000000002000000000060220
0200077080000130000000060220
2211311111111223000080067220
2111311111111111311222132222
2113331444444413331444434443
2113031007000013031070000703
2113031009000013031000000003
2113731111311113731200000023
2111111111311111111111111113
2000000113331100700007000703
2444444133033444444444444443
2070000130003000000000000803
2000000030003001111111111103
2222000030003011107110070113
2111111237073001111111111111
