d28x16
0000000000000870000000000000
0000000000011111111300080700
0000000807000000000313111113
0000071111130000000303000003
1115111000034444444303700003
0000000000030000000301111111
0700000000030000000300000000
1113111111130000000344444444
7003000800030000700300000007
1111111110011111111300001111
0000000700070000000300000000
1111131115111300700300070000
0000030000000111111111111113
0000030000000000000000000003
0000030700090000007000000003
1111111111111111111111111111
