d28x16
0007000000000000000000000003
3221223000000000007000000003
3000003000031111111113070003
3070803000030000000003111153
3121213000030000000003000006
3000003444434444440083000006
3000003000030000031112222223
3000003000030070030000000003
3000803070031111130000000003
2111211211230000000003111311
2111200000030000000003000300
2700200000030004444443000307
1111111131112222000003001111
0000000030000000000003000000
0000000030009000000003000000
1111111111111111111111111111
