d28x16
0000000000000600000000000000
4444444444400600000000000000
0070000702300607000000000000
1111111112222222300732300000
1212121222220002222222300000
0000000000220070000002308700
4444444430221111130002211113
0000000030220000038000011113
0000000030220111111113011113
0700007030220100000013011113
1118001030220100070013011713
1111111030220111111113011013
0000000030000100700013000013
1111111111111103113011111113
0000000000900003073000000003
1111111111111111111111111111
