d28x16
1110060110000110000110600111
1111061111081111081111601111
3001131001131001311001311003
3000134430130007310344310003
3081111731111331111371111093
3111001131001311001311001113
3110000137000310007310000113
3111001111331111331111001113
3001131001131001311001311003
3000130000130007310000310003
3001111331111331111331111003
3111001131001311001311001113
3110000130000310000310000113
3111001111331111331111001113
3000070000330700330000700003
3111111111111111111111111113
