d28x16
0000700007000007000000087000
3111111311101111131110111113
3000000300000000030000000003
0300000030040000300000000030
3000000300404000030000000003
0300000034000400304444444430
3444444300000040030000000003
0000800034000004300000000030
1111110300400040030000870703
1101110030040400300004111222
0700070300004000030004111222
1151110030040400300004111222
1151010300400040030004117722
0070700034000004300004222222
1111110300007090030700222222
1111111111111111111111111111
