d28x16
2000000000000000000000000006
2000007777808080000009000006
2111111111151111111111111113
0000000000000000000000000003
0000207007000000070000007203
0000211111115111111151111203
0000000000000000000000000003
0000002007000070000070020003
0000002111511111151111120003
0000000000000000000000000003
0000000200700000700007200003
0000002211111111111111200003
0000000000000000000000000003
0000000000000000000000000003
7777000800000000008000003203
1111111111222222111111122203
