d28x16
6000000000000000000000000006
6000000000000000000000000006
1111113111138083111131111111
0400003000032323000030000040
3011111000000300070011111103
3011111001333333310011111103
3011171001322222310011711103
3011111001333333310011111103
3000000000444444400000000003
3080003000000200000030000803
3222223000072227000032222223
3000003000022222000030000003
3111113000222222200031111113
3000003072222222227030000003
3222223022222222222032222223
7000003222222222222230090007
