d28x16
0000000000000600000000000000
0000000000000600000000000000
7000000000000660000000000007
1303444444444464444444443031
1133080000000000000000703311
1113034444440444444444303111
1111330700000000000000331111
1111530344444404444438351111
1111513300000000007033151111
1111511303444044443031151111
1111511133070000003311151111
1111511113034404303111151111
1111511111330000331111151111
1111511111130000311111151111
1111511111113973111111151111
1111800000003113000000001111
