d28x16
6000000000000110000000000006
6000000000000220000000000006
6070000000700110070000000706
2121212121213223121212121212
0007000007003113007000007000
3212121212121221212121212123
3000700070000110000700070003
2121212121213223121212121212
0000780870003113000780870000
3212121212121221212121212123
3007000007000110007000007003
2121212121213223121212121212
0070000000703113070000000700
3212121212121221212121212123
3000000000000900000000000003
1212121212121212121212121212
