d28x16
0000000000000000000000000000
1116111100000000044444408000
0006044008000000000000222223
0003100111113111111444000103
3111100174443444441000111131
3000000111100011131000170030
3000000144443444431000140030
3091000137173713731000100037
1311000111111111111000113111
0300007100000700001000003000
0300001100011130001000003000
0300710100000030001700311111
0300100100070030001100300000
0371000103111111301017300000
0310070103100701300001300000
1111111111111111111111111111
