d28x16
6000000000000000000000000000
6000000800000000000000000000
6111111111122222212222122223
7000000000000000000000300003
1100000000020007000074447003
1111133133111111110010001003
0000133033102211110000080003
0000133733102011110111311113
0000111111102711100000300003
0000000000000000000000300003
0000000900000001311111322223
1131111111131110307700300003
0030000000030000302200000113
0031171000030011102211111103
0031111000830007002200000003
1111111111111111112211112222
