d28x16
2222222222222220060222222222
0083000000344400060300000070
2226112222215122260322220321
2443000000034444300300011111
2003000000070171380300700011
7053000000030000213022111121
2153444444434444423444444432
1702000000030007322200000031
2251000077730000324444007033
2000000000030000323070005123
1115110000030900323000000003
1344440321112115223000000003
1370001300000000313002111103
1324411130000000323001070203
1300111213008000303000122122
2111112222111111111111112111
