d28x16
1111111111111111111111111116
1000333333333333333333300016
1090303330000300033000308016
1111303330330303303033311116
1000303330330303303000300016
1080303330330303303033308016
1111300030000300033000311116
3333333333333333333333333336
3070307030700300703070307036
3333333333333333333333333336
3000303030330303303000300036
3030303030030300303033303036
3003303030300303003000300336
3030303030330303303033303036
3030300030330303303000303036
3333333333333333333333333336
