d28x16
0000447044444444844444044444
0003071700000000340104300777
7930710170000003401110430077
1107100017000034010001043007
0805001001000340110001104308
3110011100222400017771000413
3000100010007000331110000003
3004011100073003113100000003
3000401000730003773044444443
3000040007300032222300000003
2223004443000037007304444443
0003000000000311111130000003
1113111300000370000730444443
0000000300003222222223000003
0000000300803700080073044443
1111111122222111111113000003
