d28x16
6000000000000000000000000000
6444444444440000000000000000
3000003000001070100000300000
3070033300701111107003330070
3033003003300000003300300330
3030333330300000003033333030
3030078700300030003007870030
3003111113000333000311111300
3000333330330030033033333000
3000000000303333303000000000
3000070000300787003000007000
3111111300031111130031111111
3000000300003333300030000000
3000000300000000000030000000
3000000300000007009030000000
1111111111111111111111111111
