d28x16
0000000000000000000000000000
0060000000000000000000000060
0031111111111111111111111130
0030311000700070807000113030
0031113111111111111111311130
0030303011107000781130303030
0011311130311111113031113110
0030303030303111303030303030
0031113111303070303111311130
7030303030383222383030303037
1111311137323222323731113111
1130303032323222323230303031
1131103232323222323232301131
1130323232323222323232323031
1132303030303009303030303231
1111111111113171311111111111
