d28x16
2000000000000000222222222226
2800000000800000200702000006
2244444411111309203202321116
2111110007001112203202321116
2000011111100000003202320006
1113000000111130703202320706
1011121300000031112202321116
1007001121300030000202321116
1111100001112130000202320006
1070123100000112113202327706
1110003112210070023202321116
1012113000011122123202321116
1000111211300700023202320116
1031100071112213123202320016
1031000000000003073200300076
1731211112111112112211211111
