d28x16
0000040000040400000040070070
4000404000403040000403111111
0404000404003004004003000000
0040000040003000440003008000
0700070070003000400003222223
2222222522222234000003207023
0000000000000020000003232723
0000000000000720090703232723
3111111111131223111143232723
3000008000031133000003232723
3000011000031130007800232723
3011100111031122111113234444
3011100111031100000003000000
3011177111031000004473011110
3070711707031100310013117711
1111111111111111111111111111
