d28x16
0000000000000000000000000000
0000000008000008000000007076
0000003111111111111110031111
0000003011111111111100311111
3111111001711711711003111111
3111111100000000000831111111
3111111111111151111111110000
3111111117070000707111110770
3111111111511151111111111111
3000000080000000000711111100
3003111113111113004311110073
3003003003003003000111007311
3003773773773773000100731111
3003111113111113000073111111
3000000000000009000311111111
3111111111111111111111111111
