d28x16
0000000006000000000000000000
0000000006000000070000008000
1110000006000000111131111111
0011000006000001100030000000
0001100006000011000030000000
7801110006007111000030007000
1131111006001111311131111111
0030001106011000300000000000
0037800113110000300000700000
3111300003000001311311100000
3000300000000000000300000000
3000300007000008000300000000
3000311111113111111311111311
3000000000003000000000000300
3000000000003009000000000300
1111111111111111111111111111
