d28x16
0004407000000000470000700000
0030011000000003011000113000
0030000000078003000000003007
0734400000011073008700003311
1130037800000113001100070300
0007031100000003000000110300
0011034044874443000000000300
0070000300110000700074000370
0110000300000001100110373110
0000407300700000000000311000
0003011300110007000000300000
0703000007000011070000370000
3113000011000000011000311000
3000000000000000000000000000
3000000000000090000000000000
1111111111111111111111111111
