d28x16
3000400000000000000000034444
3000030000000000000000030200
3000030000000000000800030277
3070031111007007311111513111
3110030001111111110000003315
3000030000000000000000000335
3000003444444444444444444433
3000003000000000000000000003
3000003070000000800070000073
3000001111132222222222115111
3444000000030000000000444000
0008700000030000000003000000
1111111113030007000003400070
0000000011111322231111017111
7000000090000300030008011111
1111111111111300031111111111
