d28x16
1111111111111111111110000061
1091144402200070000000000061
1012007032211111133031303061
1010000030000221033730303061
1013111121170001033030313061
1013100000021100033030303061
1703100070012103103030303061
1133115121112103171611313061
1130000008000003151610303061
1131121111111233301610303061
1130121111111233001610303831
1030020070000230001613311131
1033121111111230701613800031
1013121111111232221611110031
1013100000700221000600010031
1073012222222221080600011111
