d28x16
0000000003000000000000000000
0000000003000000700008000000
4444007006000002222222222223
3002222222000000000000000003
3000000000444440044444032222
3444444444000000003000030000
0000800000000007003100030000
3222222222222222222100022223
3000000000000000000000000033
3000000700000070000080020030
2222112222301221222222220030
0000000000300000000000000030
0000000700300000070000000030
3222222222202222222200000030
3000000000000000000044444430
3000000000090000000080000000
