d28x16
1212210000000000000621221112
1122110000000000000612211122
0002121007000000700612000002
3100021121112311200612012302
3120021221112301107620012302
3110000021122300121110712302
3211700001221300000000112370
3121111000211300444444412213
3022121170012307000000012003
3000003110002212212000012003
2111223211000000000000712003
1212223121170008000071112003
0007003221115222222511122311
3121112200080000000009000321
3211120031122122112122112221
3000700030000000000008000212
