d28x16
1611111111111111111111111111
1644444444444444444444444401
1612221222122212212312444131
1610000700007000700300073131
1673222222222222222222223231
1613144444444444444442073131
1673102222222222222222111131
1613102077777777777700071731
1673102111222222122222311131
1613100000800000000000371731
1673122222222222112222310231
1613444444444444444444003131
1612211223221212232222223731
1608000003022000030080073131
1222121112222322121221122131
0900000000000300000000000031
