d28x16
6000000000000001111111111111
6007000007000001111111111111
1111111111111130070000000000
1111111111111111111111111113
0000070800080700000000000003
3111111111111111111111111111
3000000007000000000070000000
1111111111111111111111111113
0000700000000700000070000003
3111111111111111111111111111
3000700808008000007000000000
1111111111111111111111111113
0007000000700000070000007003
3111111111111111111111111111
3000007000000000007009000000
1111111111111111111111111111
