d28x16
1111111111111111116111111111
1070000000000000006108070001
1511131111300070006111111131
1511131111111111111101110031
1000030070800000111101110031
1311111111131111111101110031
1300011111131111177101117031
1300011111131111111111111131
1300010000730000700800070131
1300011131111111311111113131
1300711130000000311111113131
1311510030000900300110003131
1311513111113111111117703131
1311513111113111111711111131
1380003117113000070080000031
1111111111111111111111111111
