d28x16
6000000000000000000000000000
6000010008010000000800080000
6444444731301131166166113000
3000000130131031071071003000
3090000010010310310010003000
1111100001103100100100003000
0000100071031071001044403000
0001000010333010000100111113
0710007100133100110050000003
1100001071031001001001000003
1000710010310010000100170003
0000107103107100310017010003
0071001031001000301001001003
0010710310010000300170100103
0100103300000700300010000013
0000003111111111111111111003
