d28x16
3080110000000000444444444444
3111110000000113000000000000
3111110000000113012121212121
3111110000000113070707070707
3117110000000113151515151515
3111110700800113151515151515
3111111111111113444444444444
3111111111111113000202020202
3009080000000003000151515111
3111111113111111113000005111
3111111113000111113111135111
3111111113117001113111135111
3111111113111170013080035111
0000000003111111003111135111
0000707003111111113111135111
1111111111111111113077035111
