d28x16
0000000000600000000000000000
0000000000600000000000000000
0708070002320004444444409000
3211122102370000000000111100
3200000002320000700000000007
3244440002320011114440000003
3200000072320070000000007003
3007211122321110000003111103
3212200002320000008703100003
3244444447320001111111100003
3200007002320007000000007003
3200021112324411114400311003
3270000002320000000070300003
3211000002320000001111100003
3000008000300000000000000003
2111211112222111211112211222
