d28x16
0000000000000000008000000000
1111111111111111111111111116
7080000010000000700107000006
1113101313111111110131011311
1113131313100700010131011311
1113131013101111010131000303
1713131313131901010131011113
1003131313131101010131013003
0313131313130071010131013111
3111031313111111010131013003
3110131313070000010130411113
3004131311111111110131013003
3110131300000000000131013111
4410131111111111111131013003
0000030000008000000031011113
1111111111111111111111080003
