d28x16
0000000000000004444400000000
0000000000444430000087007000
0000044443000000807011111113
0444300000000070111110070013
3000000000970111100078151313
3005150110111100701511101313
3007070700100701151007001313
3011051500101111000711131313
3007070700101007015150131313
3001110510101011510070131313
3007070700101010070113131313
3015051100101010111113131313
3007070700101010100013131313
3001150510101010107013131313
3000000008101010111113131313
1111111111100000000003030303
