d28x16
2600000000000000000000000062
2600877777777077777777780062
2222222222222622222222222222
0000007070000600000700700000
0000232222000600023222220000
0000037070000600003700700000
0002222223200600222222232000
0000007073000600000700730000
0023222222220602322222222200
0003007070000600300700700000
0222222222232622222222222320
0000007007030600007000700300
0232222222222622222222222220
0030000000000000000000000000
0030007007000000907000700008
1111111111111111111111111111
