d28x16
2222222222222222222222600002
2000000000800000000000600002
2000031211221320000000600002
2000030000006321211221600002
2011230000036310108144444442
2700030007636110102100000072
2000030003636100100100000082
2300030003636107190100000012
2300030003621100110100000712
2322225122620000010100000112
2304444444424444410100700012
2300000700300000110100001112
2300325222322213100100071002
2300320002320013111151210702
2300320002327013000000001122
2307320802321111122111211112
