d28x16
0000000000000000000111111100
4444444444700000086011111100
3000000003134444000601111113
3000000035153073700060110013
3444444435153011130006017013
3000000035153811130000601113
3800000033333011130000060113
1444440025352011130000006013
1170030025352000030000000663
1117030025352034434444444443
1111730025352030000000000000
1111138025352034444443117111
0000030025352030000032111111
0000030025352030000321111111
0000030009300030000321111111
1111111111111111111111111111
