d28x16
0444400000077777770000044440
3000011111111111111111100003
3022211111111111111111122203
3000011111111111111111100003
3823011111111111111111103283
2223010000100001000011103222
0003017777177771777711103000
0003011111111111111111103000
0003011111111111111111103000
0003011111111111111111103000
0003011100001000010000103000
0003011177771777717777103000
0003011111111111111111103000
0003011111111111111111103000
0003011111111111111111103000
0003000000000000000000093000
