d28x16
0000000000000000000006000000
0000800000000000200006000807
3222220222222232200016131111
3000000044400032711316131111
1131101100318030111316131171
0030011710301031100316131111
3100011115300130031116130000
3000090000300010031006011113
3111111110107100731311111113
3111111115101001111311000003
3111111115100000711300111111
3117000115144443101344444400
3110007115130001001700001013
3111111115130011111113111713
3000117000030110000003001113
3111111111131111111111100003
