d28x16
0000000000000000000000000000
0000006666666960000000600000
0000800006000066000006682000
0073700006000006600066022200
0733370006000000660660222220
7333337006000000066602222222
3333333446007807006444433300
0003000011111111111100003000
0072700010700000070100003000
0722270010444444440100003000
0222220010300000030100003000
0022200010300000030100003000
3111113017300080037100003000
3000003011111111111100003000
3000003003000000003000003000
3111113311111111111133111113
