d28x16
1000000000000000000000000016
1000000700800044444444444716
1111111111111330000807003116
1111000000000331111111111106
1111100700800330000000011006
1111111111111330070000111306
1111111000000331111111100306
0007001100700330000011151306
3111111111111330700110000306
3110101111000331111107000306
3003131071100330011111511306
2223031311119330110700000306
2222230310111331111151111306
2222222333101331000000000306
0000000003030330000000000306
1111111111111111111111111111
