d28x16
1111111111111110000000000006
1000000000000010000000000006
1044444444444433111111170006
1000000000000031007001014443
1707800000090031000001018003
1311111132222221220003001103
1300000130000001110003000003
1370000134444444000801300003
1300011230000001111111300031
1300117230000111000001311111
1300100230071171077001311011
1311000230011001111111310101
1317000230110001444441311011
1300000333100001007001317101
1300000313000000000001311011
1111111111111111111111111111
