d28x16
0000000000000000000000000006
0000000000000000000000000006
0000000000000000000008477746
0074740000000000000003711173
7310107400000000000073111113
1300001000000000007013117113
0300000074000000001343111113
0300000010000000704300711170
0300000000000000130000000000
0300000000700000030000777700
0300000000100070430007111170
0300000000000013000001111350
0300000000074003000001113510
0300000000010743000001135110
0300000000007103000001351110
0300900000001003080003511110
