d28x16
0000000007000700000000000000
0700070001131100070007000070
0113110000030000011311000131
0003000000300000000300000030
0000300000030000000030000300
0003000000083000770003000030
0030000000030000110030444403
0003000000300000000300000030
0000300000030444444030000390
0003044444083000000003000011
0030007700030000000030000000
0003001100300000000300000000
0080300000030000000030800000
1111155555555555555511111113
0000000000000000000000000003
1111111111111111111111111111
