d28x16
0060000000000000000000000000
0060000000000000000044444444
0060000000000800000030000003
1111131000013111000830000703
0000030000003000011131111111
0080030007003000000030000000
1111131111003000000030000000
0000030000003000000030000000
0070030007003000000030000000
1131111111111113000030111103
0030000000000003070030111103
0030070000000003444430107103
1111111300000000000030111113
0000000300000000000030000003
0000000309000000007030080003
1111111111111111111111111111
