d28x16
6000000000000000000000000000
6000000444444444444444444111
3000078000000000300000000001
3115111100000000300000000001
3000000100000000307830110701
3070300107000444311131111111
3111370111110700300030000000
0000311111111115300030000007
3000311007011115307134444411
3111311111111115311130703011
3000001444444444317135113011
3783001000007000311130003011
1113001000701100311130003011
0003001070110000311130003011
0003091111000070311130083011
1111111111111111111111111111
