d28x16
2222222222220602222222222222
2444444443124642134444444442
2000000703144644130700000002
2000700113447674431100700002
2007115433121612133415107002
2071144341543634514344111702
1711443444443634444434441172
1544434444443634444443444451
1444384444443634444448344441
1000311111153935111111300001
1070300000001110000000300701
3000300008001710080000300003
3444315111113031111151344443
3070030000003030000003007003
3000030070003030070003000003
1111111112111111121111112222
