d28x16
0000000000000000000000600000
0000000000000000000000600000
8000000071700000000000617000
1111131111111131311111111113
7000130700000031300001000003
1113111113111111111131311111
7003000003008000000031300007
1311111111111111311111111111
7311700100000071300008017000
1111111113111111111311111111
1130000083111701100300110071
1131111311111111131113111111
7031111310711111731113000011
1131111311111111131111113111
1130001300000109030010003007
1111111111111111111111111111
