d28x16
6000000000000000000000000006
6444444444444444444444444446
3300000000000000000000000033
3001511000011151100111111003
3001001100010000100100005003
3001000110010000000100000003
3001000010010000000100000003
3001000710010000700100000003
3001000110010001100100007003
3001701100010007100170071003
3001111000011151100115111003
3000000900000000000000000003
3031111110011111100131111003
3031000710011111130131171003
3831000010811071130031111003
1111111111111111111111111111
