d28x16
0444470000000000000000707916
0000013000000000000003111116
0000013000000000000035111116
0000013000000000000315110016
0000013000000000003115117016
0708013000000000031715115516
1111001300000000310315110016
7000170137000003107315110016
1113010011300031111315110016
7001301701378310707315110016
1130130100113111111315110016
7013013017013070704315110016
1301301301013111110315115516
0130130130000000000315110006
0030030030000080000300000006
1111111111111111111111111111
