d28x16
0444444441000000000080000000
3000000001007000031111301013
3055555501111132032000301013
3055555501007032032320301013
3055555501311112032320301013
3055775501307002032320301013
3055555501111132032320301013
3055555501007032032320301713
3000000081311112032320301153
3111111111307002032320300003
3111111111111132112321111113
3111111111007032222322221113
3117711111311112070607027113
3111111117321222222222221113
3222222222200000007008700003
3090000000031111111111111111
