d28x16
2612221221121122120221221121
2366666262122162666666221111
2309076260777060600806070061
2321216261211231321113111161
2307006260777030307113111261
2321266260111030302273711761
2366607260000037300123212261
2300611260070032300703444461
2370860260111032300123007211
2311113260010037300103011761
2300203266666632300103000232
2300203444444444378103277731
2300273211113072311111111111
2300213200011111212444444431
2307003007000700000008077731
2111111212222222222221222231
