d28x16
0000000000000080070000000000
0000000007001111113107000000
0000011151111000003111115100
0000010000001000003100000100
0000010870001000003100000100
0111111110701700131111177100
0100000011151111130000151111
0100000010000070130870000401
0100000010000311111111111031
0100070710000310000000007031
0100111110000310700313031111
0111100010713111100311151000
0000107011113000107310000000
0000111110013000111510000000
0000000000003000000900000000
2121212121212121212121212121
