d28x16
6000000000000000000000000000
6000000000000000000000000000
2222222300000000000000032222
0000000300080000000008030000
0000000311111112221111130000
0001000300000000000000030000
0010044300000000000000030000
0010707300007170000077730000
0010171344001010777011134400
0100171370744710111017137074
0100111317107170777011131710
0100001371701110111017137170
1000001317100000000011131710
0000000343000000000000034300
0000000300009000000000030000
1112221111111112222111111111
