d28x16
0000004444444444470000000000
2222220001100000122222213000
2444444007700000100000013000
2300000011150000108000713000
2377000070070000111111513000
2222307015110000000000833000
0000300000007000700084403000
0000300000122222222214403000
0000378070180000070010003000
0000311113111111511110003000
0000010013000000000000003000
0000010013000000000000003000
0000017713000000000000003000
0000011513000000000000003000
0000000003000080090000003000
1112222211122221112222111222
