d28x16
6000000000000000000000000000
6444444444444444444444444444
3108000100000000000001000001
3011111000000000000000111110
3010111000000000000000171110
3011111080000800000080111110
3011101511111111111111111010
3011111511107110711111111310
3011111511111111111111111310
3011111511111111111111111310
3011111511110000111111111310
3011111511110000111111111310
3011111511110007311111111310
3000000000001111344444444300
3000000000022220000000000000
3000000900222200000080000000
