d28x16
0000000000000060000000000000
0000000000000060000000000000
0000000000000060000000000000
0444444000800313008000444444
0000003444317313713444300000
0317013000311111113000310713
0311110000343101343000011113
0331100000003111300000001133
0031100000003101300000001130
0031100000003111300000001130
0031100000003101300000001130
0031100000003111300000001130
0031100000003101309000801130
0031111111113111311111111130
7031100070013070310070001137
2222222222222222222222222222
