d28x16
0000000000000334444333331111
0000000000003113444377031111
0000000000031111300033730303
0000000000311111130000337373
0000000000311111130000033333
0000000000312125230000030303
0000000000372125730000030303
0000000000312125230000037373
7444444444312125230000033333
3700000000372125730000030303
1370000000312125230000030303
1137000000312125230000037373
1113700000371115730000033333
1111370000311111130000030303
1111137003210120123000937373
1111113083210120123803111111
