d28x16
0400800011110800700011110000
3031111311113111111011111113
3031111300703111711011117113
3031771311111111111000011113
3011111300000444444444444443
3000001380000000070070000000
3151301311111511111113070700
3701301344444044444322222222
1101301300007070000300970070
0007301311111511111311111113
1132201344444444444300000003
1130007300007000002111111303
1131111111111111162000070303
7131000000000000062111115103
1131000007000070062000080003
1111111111111111111111111111
