d28x16
0000000000000660000000000000
0080333330077667700333330800
0000333330311111130333030000
0031303030300700030303031300
0031303030311111130303031300
0001303034300907034303031000
0007203024111111114203027000
0005303034311111134303035000
0035303034311111134303035300
0033303030031551300303033300
0033303030031551300303033300
0003303030001771000303033000
0000333030000000000303330000
0000033330000000000333300000
0000003330000000000333000000
0000000831111111111380000000
