d28x16
0060000000000000000000000000
0060000000000000000000000000
0060000004444400000000444443
0830000400000030044083000003
5134443015110031100113011511
5100003115111031100113011510
5100003118400031100113011000
5100003113011031100113401000
5107003113711031170117355790
5044343113011031100110311110
1103300113001031100110311110
1133000113050431100110311000
1130000113011001100110311000
1130744113007000107100300070
1111130111111300115100311113
1111130711110300715700311111
