d28x16
0000000000000000003000600000
0000000044000000003000600000
7000700440300000443007680000
1111344000308004441511313000
0000300215130044471700613000
5511130070034322021111113000
5700030020000300022220443000
0570030000007307000003200000
0017031511322222231523200000
0031730000300700030003200000
0030532000315111131123200000
0030430070300700030023200000
0032070020311115130273720000
0030020000300700030223220000
0030000000311511130083000000
1111111111300800931111111111
