d28x16
2600000000000000000000000002
2622220222222222122222222272
2600007000744440004444444432
2600000003110011111000001132
2600000703000000071001071732
2600001113007090011001511232
2607000003111113001080000032
2601110003100013001444311112
2600000803170013001000344402
2600031111111113111000300702
2111031701070010001000301112
2701131111111110001000301002
2111134447727717001122232112
2000130011121111131000030072
2070130000700000033008031302
1111131111111111113111111111
