d28x16
0044400000070070000444002013
1100130000311113003800112003
0110130003111111111130112013
1100131111171171111130172113
7117130000080000000030000013
1111111111111111151111111113
0007080007000000000090008003
2222222222222222311111111111
0444444444444402300000000000
3000000400000032344444444440
3000004040000032110110110113
3000040104000032222222222223
3000401110400034444444444443
3004011111040035151515151515
3040117771104032000000000000
3401111111110432000000008000
