d28x16
0000000000000000000000006000
0000000000000007000001816100
0000003444311111111111016100
7044443000010000007001016100
1300000000010000111111016100
1130000008010000700000016100
1113000007010000044444016100
1111304444417007100003006000
2222223000011111100003446000
0000003000011111100003011111
0000003000011111100003017080
0000003000011111100003011113
0000003000000000000003000003
0000443000000000000003000003
8071003000000090000003000003
1111003117111111111113001113
